Years of chasing the notorious criminal, Sum Ting Wong, has left you exhausted and on the verge of retiring your badge. But you have reaffirmed your resolve by remembering little Jamoca, a five year old girl who had her puppy, Lucky, flattened into a carpet by Wong's get away vehicle. Now you've arrived in the slums of Callustine in hope that some clues in the criminal's home town may lead you to catching the scumbag.

Any Given Psycho
An Interactive Fiction by Riley Kam
Release 1 / Serial number 141028 / Inform 7 build 6L38 (I6/v6.33 lib 6/12N) SD

Got Chu
Apparently this town has a weird sense of humor when it comes to naming their buildings. Outside of this dreary grocery store are some fruits and vegetables. A small wagon seems to be bringing in some new product. There are also some tents for an outrageous price outside the store. To the north is the community center.

I beg your pardon?

>n
Community Center
When push came to shove it seems like the community center didn't get the funds that it needed. It's really quite sad that this significant pillar in the community is no better than a trash collection center. There is a group of locals in the corner huddled around an old television. A small trashcan fire acts as the poor places heater. To the south is Got Chu. To the east is the Town Hall. 

The Trashcan Fire burns strongly in the room keeping this place warm. People also insert things into the fire to dispose of them.

>e
Town Hall
While marble pillars stand firm at the front of the states main building. . It would hold the impression of a civil war building if it weren't for the Chinese fireworks blatantly sticking out of the windows. Although its not open it seems as though a town official is waiting outside next to some crates. The Community center is west and the Water Basin is North. To the south is an Apartment complex with Wong's room.

>n
Water Basin
 This lively part of the concrete jungle, teeming with a rich biodiversity consisting of construction workers and employees. Concrete has long filled in this once teeming riverbed, now all thats left are some exposed drainage pipes. Some of the areas still seem to be undone, one of which has a large blue tarp covering the exposed surface. To the west is the REC center, to the east is WOK INN, to the south is the Town Hall.

>look under tarp
As you peak under the tarp you notice something sticking out from underneath the material. You reach in and pocket the item.

>i
You are carrying:
  a Pearl

>x pearl
 When looking closely at this pricey pebble you notice the letters STW on the face of the pearl.

>e
WOK INN
When it comes to play on words this old Chinese restaurant is a clear winner. Supposedly this place was Wong's favorite hang out but has clearly fallen out of grace. Dilapidated tables can barely hold the teacups, chopsticks and plates that rest on them. An old man sits in the corner with his head down, most likely the owner of this spit trap. The Water Basin is West.

>RICE
Nothing happens.
Then all of a sudden the whole restaurant shakes, bowls fall off the counters and the utensils fall to the floor. The old man in the corner remains the same, still and sleeping. As the quake comes to a halt you slowly regain your senses. Something about the room feels different...
.

>l
WOK INN
When it comes to play on words this old Chinese restaurant is a clear winner. Supposedly this place was Wong's favorite hang out but has clearly fallen out of grace. Dilapidated tables can barely hold the teacups, chopsticks and plates that rest on them. An old man sits in the corner with his head down, most likely the owner of this spit trap. The Water Basin is West.

You can see a freezer door here.

>x freezer door
Well the poorly applied wall plaster has been shaken off and revealed a secret iron door. The door seems to have a key hole shaped like a small circle. You  might wanna see what you got kiddo.

>e
(first opening the freezer door)
It seems to be locked.

>use pearl to unlock door
That's not a verb I recognise.

>open freezer door with pearl
You unlock the freezer door.

>e
(first opening the freezer door)

Hideout
When entering the dark passage you are blinded by an overwhelming light produced by 200 Gold Blocks. In the center of the room a map rest on top of a small graphing table. There is no sign of Wong but there is a human sized safe directly across from the entrance. The way back to WOK INN is to the west.

You can see a freezer door and a Safe (closed) here.

* * *

>x vegetables
 Old and rotting, these poor excuses for human beings sit outside the store begging for spare change.

>x fruits
These are actually edible, unlike their adjacent counterparts. But just because their edible doesn't mean you should eat them.

>eat fruits
Unless you want ebola I'd put that down son.

>i
You are carrying nothing.

>take fruits
Taken.

* * *

>e
You can't go that way.

>n
Water Basin
 This lively part of the concrete jungle, teeming with a rich biodiversity consisting of construction workers and employees. Concrete has long filled in this once teeming riverbed, now all thats left are some exposed drainage pipes. Some of the areas still seem to be undone, one of which has a large blue tarp covering the exposed surface. To the west is the REC center, to the east is WOK INN, to the south is the Town Hall.

>e
WOK INN
When it comes to play on words this old Chinese restaurant is a clear winner. Supposedly this place was Wong's favorite hang out but has clearly fallen out of grace. Dilapidated tables can barely hold the teacups, chopsticks and plates that rest on them. An old man sits in the corner with his head down, most likely the owner of this spit trap. The Water Basin is West.

>RICE
Nothing Happens.
Then all of a sudden whole restaurant shakes, bowls fall off the counters and the utensils fall to the floor. The old man in the corner remains the same, still and sleeping. As the quake comes to a halt you slowly regain your senses. Something about the room feels different...
.

>RICE
Nothing Happens.
.

>RICE
Nothing Happens.
.

* * *

>take vegetables
 Brah, no can carry people. Besides do you want to give the homeless a piggy bank.

>i
You are carrying nothing.

* * *

>take vegetables
 Brah, no can carry people. Besides do you want to give the homeless a piggy bank.

>x vegetables
You can't see any such thing.

>x fruits
You can't see any such thing.

* * *

>n
Community Center
When push came to shove it seems like the community center didn't get the funds that it needed. It's really quite sad that this significant pillar in the community is no better than a trash collection center. There is a group of locals in the corner huddled around an old television. A small trashcan fire acts as the poor places heater. To the south is Got Chu. To the east is the Town Hall.

>e
Town Hall
While marble pillars stand firm at the front of the states main building. . It would hold the impression of a civil war building if it weren't for the Chinese fireworks blatantly sticking out of the windows. Although its not open it seems as though a suspicious town official is waiting outside next to some crates. The Community center is west and the Water Basin is North. To the south is an Apartment complex with Wong's room.

>x town official
 As you look closer you can see that the man in the suit has a, Hello Ny Name Is, name tag labeled Wu Hu.

>l
Town Hall
While marble pillars stand firm at the front of the states main building. . It would hold the impression of a civil war building if it weren't for the Chinese fireworks blatantly sticking out of the windows. Although its not open it seems as though a town official is waiting outside next to some crates. The Community center is west and the Water Basin is North. To the south is an Apartment complex with Wong's room.

You can see Wu Hu here.

* * *

>x town official
 As you look closer you can see that the man in the suit has a, Hello Ny Name Is, name tag labeled Wu Hu.

>ask wu hu about sum ting wong
Wu responds sternly saying "I don't want to play games. I'll tell you about Wong if you dispose of these papers for me." He hands you some papers.

>i
You are carrying:
  Illicit files

>x files
Why are you examining these they probably contain information that can get you killed. Well I guess a quick peak wouldn't hurt, lets see what we have...... grandmas shouldn't wear bikini's.

>e
You can't go that way.

>w
Community Center
When push came to shove it seems like the community center didn't get the funds that it needed. It's really quite sad that this significant pillar in the community is no better than a trash collection center. There is a group of locals in the corner huddled around an old television. A small trashcan fire acts as the poor places heater. To the south is Got Chu. To the east is the Town Hall. 

The Trashcan Fire burns strongly in the room keeping this place warm. People also insert things into the fire to dispose of them.

* * *

>x town official
 As you look closer you can see that the man in the suit has a, Hello Ny Name Is, name tag labeled Wu Hu.

>ask Wu Hu about Sum Ting Wong
Wu responds sternly saying "I don't want to play games. I'll tell you about Wong if you dispose of these papers for me." He hands you some papers.

>i
You are carrying:
  Illicit files

>w
Community Center
When push came to shove it seems like the community center didn't get the funds that it needed. It's really quite sad that this significant pillar in the community is no better than a trash collection center. There is a group of locals in the corner huddled around an old television. A small trashcan fire acts as the poor places heater. To the south is Got Chu. To the east is the Town Hall. 

The Trashcan Fire burns strongly in the room keeping this place warm. People also insert things into the fire to dispose of them.

>Insert illicit files into trashcan fire
Bird

I beg your pardon?

>insert illicit files into the trashcan fire
Bird

I beg your pardon?

I beg your pardon?

>insert illicit files into the fire
Bird

>Insert illicit files into the fire
Bird

* * *

>e
Town Hall
While marble pillars stand firm at the front of the states main building. . It would hold the impression of a civil war building if it weren't for the Chinese fireworks blatantly sticking out of the windows. Although its not open it seems as though a suspicious town official is waiting outside next to some crates. The Community center is west and the Water Basin is North. To the south is an Apartment complex with Wong's room.

>n
Water Basin
 This lively part of the concrete jungle, teeming with a rich biodiversity consisting of construction workers and employees. Concrete has long filled in this once teeming riverbed, now all thats left are some exposed drainage pipes. Some of the areas still seem to be undone, one of which has a large blue tarp covering the exposed surface. To the west is the REC center, to the east is WOK INN, to the south is the Town Hall.

>look under tarp
You find nothing of interest.

>i
You are carrying nothing.

>look under tarp
You find nothing of interest.

>look under the Tarp
You find nothing of interest.

* * *

>e
WOK INN
When it comes to play on words this old Chinese restaurant is a clear winner. Supposedly this place was Wong's favorite hang out but has clearly fallen out of grace. Dilapidated tables can barely hold the teacups, chopsticks and plates that rest on them. An old man sits in the corner with his head down, most likely the owner of this spit trap. The Water Basin is West.

>rice
Nothing happens.
Then all of a sudden the whole restaurant shakes, bowls fall off the counters and the utensils fall to the floor. The old man in the corner remains the same, still and sleeping. As the quake comes to a halt you slowly regain your senses. Something about the room feels different...
.

>rice
Nothing happens.
.

>rice
Nothing happens.
.

* * *

>e
Town Hall
While marble pillars stand firm at the front of the states main building. . It would hold the impression of a civil war building if it weren't for the Chinese fireworks blatantly sticking out of the windows. Although its not open it seems as though a suspicious town official is waiting outside next to some crates. The Community center is west and the Water Basin is North. To the south is an Apartment complex with Wong's room.

>s
Wong's Room
 When it comes to living in luxury this place falls down a flight of stairs. Wong supposing lives in this small one bedroom apartment. His bed has a red stained sheet and his dresser has clothes strung all over it. There is a barely running toilet in the corner next to a small white cabinet. To the north is the town hall.

>take lighter
Taken.

>n
Town Hall
While marble pillars stand firm at the front of the states main building. . It would hold the impression of a civil war building if it weren't for the Chinese fireworks blatantly sticking out of the windows. Although its not open it seems as though a town official is waiting outside next to some crates. The Community center is west and the Water Basin is North. To the south is an Apartment complex with Wong's room.

>e
You can't go that way.

>light the chinese fire works with the lighter
I only understood you as far as wanting to light Chinese Fireworks.

>i
You are carrying:
  a broken lighter

>n
Water Basin
 This lively part of the concrete jungle, teeming with a rich biodiversity consisting of construction workers and employees. Concrete has long filled in this once teeming riverbed, now all thats left are some exposed drainage pipes. Some of the areas still seem to be undone, one of which has a large blue tarp covering the exposed surface. To the west is the REC center, to the east is WOK INN, to the south is the Town Hall.

* * *

>e
WOK INN
When it comes to play on words this old Chinese restaurant is a clear winner. Supposedly this place was Wong's favorite hang out but has clearly fallen out of grace. Dilapidated tables can barely hold the teacups, chopsticks and plates that rest on them. An old man sits in the corner with his head down, most likely the owner of this spit trap. The Water Basin is West.

>w
Water Basin
 This lively part of the concrete jungle, teeming with a rich biodiversity consisting of construction workers and employees. Concrete has long filled in this once teeming riverbed, now all thats left are some exposed drainage pipes. Some of the areas still seem to be undone, one of which has a large blue tarp covering the exposed surface. To the west is the REC center, to the east is WOK INN, to the south is the Town Hall.

>w
REC Center
The (REC) in REC center is not supposed to be the adjective that describes the establishment. Inside of the building a broken barbell,  treadmill and leg press are clumped together. A full length mirror trends the northern wall of the gymnasium. There is a lone equipment cage with something stored inside. To the east is the water basin.

>throw barbell at cage
(first taking Barbell)
 As you chuck the barbell at the cage the rusted door shatters and the cage opens.

>take fuel
You can't see any such thing.

>x boxes
Opening up the boxes yields exactly what your looking for. You find fuel compatible with your lighter and take it.

>combine fuel with broken lighter
You can't see any such thing.

>i
You are carrying:
  Fuel
  Barbell
  a broken lighter

>combine fuel with a broken lighter
You can't see any such thing.

>combine broken lighter with fuel
You fill the the lighter with the fuel that you found making a now working lighter. This bad boy can light anything cigarettes to Chinese novelty items.

>n
You can't go that way.

>e
Water Basin
 This lively part of the concrete jungle, teeming with a rich biodiversity consisting of construction workers and employees. Concrete has long filled in this once teeming riverbed, now all thats left are some exposed drainage pipes. Some of the areas still seem to be undone, one of which has a large blue tarp covering the exposed surface. To the west is the REC center, to the east is WOK INN, to the south is the Town Hall.

>s
Town Hall
While marble pillars stand firm at the front of the states main building. . It would hold the impression of a civil war building if it weren't for the Chinese fireworks blatantly sticking out of the windows. Although its not open it seems as though a town official is waiting outside next to some crates. The Community center is west and the Water Basin is North. To the south is an Apartment complex with Wong's room.

>i
You are carrying:
  a lighter
  Barbell
  a broken lighter

>light the chinese fire works with the lighter
I only understood you as far as wanting to light Chinese Fireworks.

* * *

>e
Town Hall
While marble pillars stand firm at the front of the states main building. . It would hold the impression of a civil war building if it weren't for the Chinese fireworks blatantly sticking out of the windows. Although its not open it seems as though a suspicious town official is waiting outside next to some crates. The Community center is west and the Water Basin is North. To the south is an Apartment complex with Wong's room.

>e
You can't go that way.

>x town official
 As you look closer you can see that the man in the suit has a, Hello Ny Name Is, name tag labeled Wu Hu.

>x Wu Hu
You see nothing special about Wu Hu.

>x town official
You see nothing special about Wu Hu.

* * *

>e
Town Hall
While marble pillars stand firm at the front of the states main building. . It would hold the impression of a civil war building if it weren't for the Chinese fireworks blatantly sticking out of the windows. Although its not open it seems as though a suspicious town official is waiting outside next to some crates. The Community center is west and the Water Basin is North. To the south is an Apartment complex with Wong's room.

>light chinese fireworks
This dangerous act would achieve little.

* * *

>e
Town Hall
While marble pillars stand firm at the front of the states main building. . It would hold the impression of a civil war building if it weren't for the Chinese fireworks blatantly sticking out of the windows. Although its not open it seems as though a suspicious town official is waiting outside next to some crates. The Community center is west and the Water Basin is North. To the south is an Apartment complex with Wong's room.

>light fireworks
This dangerous act would achieve little.

>light the fireworks
This dangerous act would achieve little.

>i
You are carrying nothing.

>light fireworks
This dangerous act would achieve little.

>light matches
You can't see any such thing.

>light fireworks
This dangerous act would achieve little.

* * *

>n
Community Center
When push came to shove it seems like the community center didn't get the funds that it needed. It's really quite sad that this significant pillar in the community is no better than a trash collection center. There is a group of locals in the corner huddled around an old television. A small trashcan fire acts as the poor places heater. To the south is Got Chu. To the east is the Town Hall.

>insert broken lighter into the trashcan
You can't see any such thing.

>insert fuel into the trashcan fire
You can't see any such thing.

* * *

>n
Community Center
When push came to shove it seems like the community center didn't get the funds that it needed. It's really quite sad that this significant pillar in the community is no better than a trash collection center. There is a group of locals in the corner huddled around an old television. A small trashcan fire acts as the poor places heater. To the south is Got Chu. To the east is the Town Hall.

>x fire
The Trashcan Fire burns strongly in the room keeping this place warm. People also insert things into the fire to dispose of them.

>x trashcan
The Trashcan Fire burns strongly in the room keeping this place warm. People also insert things into the fire to dispose of them.

>take fire
That's fixed in place.

* * *

>RICE
NOTHING HAPPENS FOO. There is a time and place for everything but apparently you don't know that.

>RICE
NOTHING HAPPENS FOO. There is a time and place for everything but apparently you don't know that.

>n
Water Basin
 This lively part of the concrete jungle, teeming with a rich biodiversity consisting of construction workers and employees. Concrete has long filled in this once teeming riverbed, now all thats left are some exposed drainage pipes. Some of the areas still seem to be undone, one of which has a large blue tarp covering the exposed surface. To the west is the REC center, to the east is WOK INN, to the south is the Town Hall.

>e
WOK INN
When it comes to play on words this old Chinese restaurant is a clear winner. Supposedly this place was Wong's favorite hang out but has clearly fallen out of grace. Dilapidated tables can barely hold the teacups, chopsticks and plates that rest on them. An old man sits in the corner with his head down, most likely the owner of this spit trap. The Water Basin is West.

You can see a freezer door here.

>RICE
Nothing happens.
Then all of a sudden the whole restaurant shakes, bowls fall off the counters and the utensils fall to the floor. The old man in the corner remains the same, still and sleeping. As the quake comes to a halt you slowly regain your senses. Something about the room feels different...
.

>RICE
Nothing happens.
.

>n
You can't go that way.

>r
That's not a verb I recognise.

* * *

>ne
You can't go that way.

>n
Water Basin
 This lively part of the concrete jungle, teeming with a rich biodiversity consisting of construction workers and employees. Concrete has long filled in this once teeming riverbed, now all thats left are some exposed drainage pipes. Some of the areas still seem to be undone, one of which has a large blue tarp covering the exposed surface. To the west is the REC center, to the east is WOK INN, to the south is the Town Hall.

* * *

>e
WOK INN
When it comes to play on words this old Chinese restaurant is a clear winner. Supposedly this place was Wong's favorite hang out but has clearly fallen out of grace. Dilapidated tables can barely hold the teacups, chopsticks and plates that rest on them. An old man sits in the corner with his head down, most likely the owner of this spit trap. The Water Basin is West.

>e
You can't go that way.

>n
You can't go that way.

>RICE
The whole restaurant shakes, bowls fall off the counters and the utensils fall to the floor. The old man in the corner remains the same, still and sleeping. After further inspection it seems as though the quake was not a result of the building's silly puddy support beams or an earthquake. The room feels, different...

>l
WOK INN
When it comes to play on words this old Chinese restaurant is a clear winner. Supposedly this place was Wong's favorite hang out but has clearly fallen out of grace. Dilapidated tables can barely hold the teacups, chopsticks and plates that rest on them. An old man sits in the corner with his head down, most likely the owner of this spit trap. The Water Basin is West.

You can see a freezer door here.

>e
(first opening the freezer door)
It seems to be locked.

>open freezer door
It seems to be locked.

>unlock
(Rice with Rice)
That doesn't seem to be something you can unlock.