Years of chasing the notorious criminal, Sum Ting Wong, has left you exhausted and on the verge of retiring your badge. But you have reaffirmed your resolve by remembering little Jamoca, a five year old girl who had her puppy, Lucky, flattened into a carpet by Wong's get away vehicle. Now you've arrived in the slums of Callustine in hope that the criminals home town may lead you to catching the scumbag.

Any Given Psycho
An Interactive Fiction by Riley Kam
Release 1 / Serial number 141022 / Inform 7 build 6L38 (I6/v6.33 lib 6/12N) SD

Town Hall
While marble pillars stand firm at the front of the states main building. . It would hold the impression of a civil war building if it weren't for the Chinese fireworks blatantly sticking out of the windows. Although its not open it seems as though a town official is waiting outside next to some crates. The Community center is west and the Water Basin is North. To the south is an Apartment complex with Wong's room.

>n
Water Basin
 This lively part of the concrete jungle, teeming with a rich biodiversity consisting of construction workers and employees. Concrete has long filled in this once teeming riverbed, now all thats left are some exposed drainage pipes. Some of the areas still seem to be undone, one of which has a large blue tarp covering the exposed surface. To the west is the REC center, to the east is WOK INN, to the south is the Town Hall.

* * *

>e
WOK INN
When it comes to play on words this old Chinese restaurant is a clear winner. Supposedly this place was Wong's favorite hang out but has clearly fallen out of grace. Dilapidated tables can barely hold the teacups, chopsticks and plates that rest on them. An old man sits in the corner with his head down, most likely the owner of this spit trap. The Water Basin is West.

>x door
asdfa

>RICE
The whole restaurant shakes, bowls fall off the counters and the utensils fall to the floor. The old man in the corner remains the same, still and sleeping.

>x door
Asda

* * *

>e
WOK INN
When it comes to play on words this old Chinese restaurant is a clear winner. Supposedly this place was Wong's favorite hang out but has clearly fallen out of grace. Dilapidated tables can barely hold the teacups, chopsticks and plates that rest on them. An old man sits in the corner with his head down, most likely the owner of this spit trap. The Water Basin is West.

>RICE
Nothing happens Dumbass.
Then all of a sudden the whole restaurant shakes, bowls fall off the counters and the utensils fall to the floor. The old man in the corner remains the same, still and sleeping. As the quake comes to a halt you slowly regain your senses. Something about the room feels different...
.

>l
WOK INN
When it comes to play on words this old Chinese restaurant is a clear winner. Supposedly this place was Wong's favorite hang out but has clearly fallen out of grace. Dilapidated tables can barely hold the teacups, chopsticks and plates that rest on them. An old man sits in the corner with his head down, most likely the owner of this spit trap. The Water Basin is West.

You can see a freezer door here.

>x freezer door
Asda

* * *

>RICE
Nothing happens Dumbass.
Then all of a sudden the whole restaurant shakes, bowls fall off the counters and the utensils fall to the floor. The old man in the corner remains the same, still and sleeping. As the quake comes to a halt you slowly regain your senses. Something about the room feels different...
.

>RICE
Nothing happens Dumbass.
.

>RICE
Nothing happens Dumbass.
.

>n
You can't go that way.

>e
(first opening the freezer door)
It seems to be locked.

>s
You can't go that way.

>w
Water Basin
 This lively part of the concrete jungle, teeming with a rich biodiversity consisting of construction workers and employees. Concrete has long filled in this once teeming riverbed, now all thats left are some exposed drainage pipes. Some of the areas still seem to be undone, one of which has a large blue tarp covering the exposed surface. To the west is the REC center, to the east is WOK INN, to the south is the Town Hall.

* * *

>e
WOK INN
When it comes to play on words this old Chinese restaurant is a clear winner. Supposedly this place was Wong's favorite hang out but has clearly fallen out of grace. Dilapidated tables can barely hold the teacups, chopsticks and plates that rest on them. An old man sits in the corner with his head down, most likely the owner of this spit trap. The Water Basin is West.

You can see a freezer door here.

* * *

>e
You can't go that way.

>e
(first opening the secret door)
It seems to be locked.

>e
(first opening the secret door)
It seems to be locked.

>e
You can't go that way.

>e
You can't go that way.

>RICE
The whole restaurant shakes, bowls fall off the counters and the utensils fall to the floor. The old man in the corner remains the same, still and sleeping. As the quake comes to a halt you slowly regain your senses. Something about the room feels different...
. We go on.

>i
You are carrying:
  Rice

>l
WOK INN
When it comes to play on words this old Chinese restaurant is a clear winner. Supposedly this place was Wong's favorite hang out but has clearly fallen out of grace. Dilapidated tables can barely hold the teacups, chopsticks and plates that rest on them. An old man sits in the corner with his head down, most likely the owner of this spit trap. The Water Basin is West.

>e
You can't go that way.

* * *

>RICE
The whole restaurant shakes, bowls fall off the counters and the utensils fall to the floor. The old man in the corner remains the same, still and sleeping. As the quake comes to a halt you slowly regain your senses. Something about the room feels different...
. We go on.

>l
WOK INN
When it comes to play on words this old Chinese restaurant is a clear winner. Supposedly this place was Wong's favorite hang out but has clearly fallen out of grace. Dilapidated tables can barely hold the teacups, chopsticks and plates that rest on them. An old man sits in the corner with his head down, most likely the owner of this spit trap. The Water Basin is West.

You can see a freezer door here.

* * *

>RICE
The whole restaurant shakes, bowls fall off the counters and the utensils fall to the floor. The old man in the corner remains the same, still and sleeping. As the quake comes to a halt you slowly regain your senses. Something about the room feels different...
. We go on.

>RICE
. We go on.

>RICE
. We go on.

>RCIE
That's not a verb I recognise.

* * *

>w
Water Basin
 This lively part of the concrete jungle, teeming with a rich biodiversity consisting of construction workers and employees. Concrete has long filled in this once teeming riverbed, now all thats left are some exposed drainage pipes. Some of the areas still seem to be undone, one of which has a large blue tarp covering the exposed surface. To the west is the REC center, to the east is WOK INN, to the south is the Town Hall.

>w
REC Center
The (REC) in REC center is not supposed to be the adjective that describes the establishment. Inside of the building a broken barbell,  treadmill and leg press are clumped together. A full length mirror trends the northern wall of the gymnasium. There is a lone equipment cage holding a couple boxes inside of it. To the east is the water basin.

>e
Water Basin
 This lively part of the concrete jungle, teeming with a rich biodiversity consisting of construction workers and employees. Concrete has long filled in this once teeming riverbed, now all thats left are some exposed drainage pipes. Some of the areas still seem to be undone, one of which has a large blue tarp covering the exposed surface. To the west is the REC center, to the east is WOK INN, to the south is the Town Hall.

>s
Town Hall
While marble pillars stand firm at the front of the states main building. . It would hold the impression of a civil war building if it weren't for the Chinese fireworks blatantly sticking out of the windows. Although its not open it seems as though a town official is waiting outside next to some crates. The Community center is west and the Water Basin is North. To the south is an Appartment complex with Wong's room.

>w
Community Center
When push came to shove it seems like the community center didn't get the funds that it needed. It's really quite sad that this significant pillar in the community is no better than a trash collection center. There is a group of locals in the corner huddled around an old television. A small trashcan fire acts as the poor places heater. To the south is Got Chu. To the West is the Town Hall.

* * *

>e
You can't go that way.

>RICE
The whole restaurant shakes, bowls fall off the counters and the utensils fall to the floor. The old man in the corner remains the same, still and sleeping.

>e
You can't go that way.

>l
WOK INN
When it comes to play on words this old Chinese restaurant is a clear winner. Supposedly this place was Wong's favorite hang out but has clearly fallen out of grace. Dilapidated tables can barely hold the teacups, chopsticks and plates that rest on them. An old man sits in the corner with his head down, most likely the owner of this spit trap. The Water Basin is West.

* * *

>RICE
Nothing happens.

>RICE
Nothing happens.

* * *

>ne
You can't go that way.